 ###################
 #f.......#........#
 #.##.###.#.###.##.#
 #.................#
 #.##.#.#####.#.##.#
 #....#...#...#....#
 ####.### # ###.####
 xxx#.#   0   #.#xxx
 ####.# ##-## #.####
 #   .  #123#  .   #
 ####.# ##### #.####
 xxx#.#       #.#xxx
 ####.# ##### #.####
 #........#........#
 #.##.###.#.###.##.#
 #..#.....P.....#..#
 ##.#.#.#####.#.#.##
 #....#...#...#....#
 #.######.#.######.#
 #................f#
 ###################
