 ###################
 #.f...#.....#.....#
 #...............#.#
 #...####...####.#.#
 ##..#....#....#.#.#
 #...#..#####..#.#.#
 #.###....0....#.#.#
 #...#..##-##..#...#
 #...#..#123#..#####
 ##..#..#####..#...#
 #................##
 #...##.......##...#
 #..##...###...#...#
 #...#...#x#...##..#
 ##..#...###...#..##
 #...#....P....##..#
 #...####.#..###..##
 ###......#........#
 #...###########...#
 #.............#..f#
 ###################